胎囊	GS	孕囊，胚囊
胎芽	FE	
胎头	FH	
颈项透明层厚度	NT	颈项部软组织厚度
胎心	HR	
胎动	FM	
头臀长	CRL	
双顶径	BPD	
头围	HC	
腹围	AC	
股骨长	FL	股骨径
肱骨长	HL	肱骨径
枕额径	OFD	前后径
小脑横径	TCD	
腹横径		腹径，腹前后径
羊水深度	AFV	最大羊水深度，最大羊水暗区
羊水指数	AFI	
宫颈长度		
胎儿体重	EFW	
脐动脉S/D值		脐动脉值、脐动脉血流比值
阻力指数	RI	
搏动指数	PI	
胎盘	PL	
胎盘位置		
胎盘分级	GP	胎盘成熟度
脊椎	SP	脊柱
腿部皮下脂肪厚度	FTH	
胎位		
左枕前	LOA	
左枕横	LOT	
左枕后	LOP	
右枕前	ROA	
右枕横	ROT	
右枕后	ROP	
左骶前	LSA	
左骶横	LST	
左骶后	LSP	
右骶横	RST	
右骶前	RSA	
右骶后	RSP	
左肩前	LScA	
左肩后	LScP	
右肩前	RScA	
右肩后	RScP	
脐带绕颈		
颅后窝池深度		
侧脑室增宽		
肾盂分离		
胎盘前置		
小脑延髓池深度		